he variable lines is initialized with the input.
The variable upper is initialized with the first character of the second word of the input.
The output is the concatenation of the string "A" and the variable upper and the string "C".
<<<Output>>>
AAtCoder Beginner ContestC
[END-OF-RESPONSE]



TASK:
Consider the following code:
<Code>
import java.util.Scanner;

public class Main {
    public static void main(String[] args) {
        Scanner sc = new Scanner(System.in);
        String[] lines = sc.nextLine().split(" ");
        int a = Integer.parseInt(lines[0]);
        int b = Integer.parseInt(lines[1]);
        int c = Integer.parseInt(lines[2]);
        int d = Integer.parseInt(lines[3]);
        int e = Integer.parseInt(lines[4]);
        int f = Integer.parseInt(lines[5]);
        int g = Integer.parseInt(lines[6]);
        int h = Integer.parseInt(lines[7]);
        int i = Integer.parseInt(lines[8]);
        int j = Integer.parseInt(lines[9]);
        int k = Integer.parseInt(lines[10]);
        int l = Integer.parseInt(lines[11]);
        int m = Integer.parseInt(lines[12]);
        int n = Integer.parseInt(lines[13]);
        int o = Integer.parseInt(lines[14]);
        int p = Integer.parseInt(lines[15]);
        int q = Integer.parseInt(lines[16]);
        int r = Integer.parseInt(lines[17]);
        int s = Integer.parseInt(lines[18]);
        int t = Integer.parseInt(lines[19]);
        int u = Integer.parseInt(lines[20]);
        int v = Integer.parseInt(lines[21]);
        int w = Integer.parseInt(lines[22]);
        int x = Integer.parseInt(lines[23]);
        int y = Integer.parseInt(lines[24]);
        int z = Integer.parseInt(lines[25]);
        int sum = a + b + c + d + e + f + g + h + i + j + k + l + m + n + o + p + q + r + s + t + u + v + w + x